slippery  —  скользкий
indifferent  —  безразличный
mitigation  —  смягчение
knit  —  вязать, соединять
Distinguish  —  различать
praice  —  хвалить похвала
affectionate  —  нежный
encounter  —  случайная встреча
evolve  —  развиваться
further  —  дальше
insulate  —  изолировать
explicit  —  подробный
determine  —  определять
vigorous  —  энергичный
retribution  —  возмездие
against  —  против
hostile  —  вражеский
intention  —  намерение
injure  —  ранить
injury  —  рана
unintentionally  —  непреднамеренно
messy  —  неряшливый
detours  —  объезд
gamble  —  играть в азартные игры
sack  —  увольнять
rather  —  скорее
above  —  над
affect  —  оказывать влияние
although  —  хотя
amount  —  количество
apart  —  в стороне
approach  —  подходить, подход
argue  —  спорить
benefit  —  выгода
bother  —  надоедать
bring  —  приносить
calm  —  спокойный
carry  —  нести
circumstance  —  обстоятельство
commit  —  совершать
complicate  —  затруднять
concern  —  касаться, иметь отношение
consider  —  рассматривать, обсуждать
conversation  —  разговор, беседа
crawl  —  ползать
dare  —  отваживаться
demand  —  спрос
describe  —  описывать
deserve  —  заслуживать
desire  —  жаждать, очень хотеть
due  —  должный
engage  —  привлекать
especially  —  особенно
excite  —  взволновать
excuse  —  извиняться
figure  —  думать, полагать
frighten  —  пугать
gain  —  зарабатывать
gather  —  собираться #(о людях, животных)
however  —  однако
increase  —  возрастать
instead  —  вместо, взамен
intend  —  намереваться
lean  —  наклонять
less  —  меньше, менее
neither  —  ни тот, ни другой
occur  —  происходить
offer  —  предлагать
opportunity  —  возможность
particular  —  конкретный, частный
pour  —  литься #(о воде, свете)
pretend  —  притворяться
prevent  —  предотвращать
reduce  —  понижать
refer  —  направлять
refuse  —  отказывать
regret  —  сожаление
relate  —  относиться
reveal  —  открывать, разоблачать
satisfy  —  удовлетворять
seek  —  искать
several  —  несколько
shift  —  перемещать
shout  —  кричать
sigh  —  вздыхать
sight  —  зрение
sink  —  раковина
spread  —  распространение
struggle  —  борьба
suffer  —  страдать
suggest  —  предлагать
though  —  хотя, несмотря на
tight  —  тугой
tongue  —  язык
treat  —  обращаться
unite  —  объединять
waste  —  терять даром
whether  —  ли
whole  —  весь, целый
whose  —  чей
worth  —  ценность
wrap  —  сворачивать
advance  —  развиваться
consideration  —  рассмотрение, обсуждение
submit  —  представлять на рассмотрение
conviction  —  уверенность
establish  —  устанавливать
pancake  —  блин
incredibly  —  невероятно
Слова из материалов
extensibility  —  расширяемость
conjunction  —  соединение
common  —  общий, всеобщий, публичный, распространённый
consumer  —  потребитель
recive  —  получать
convoluted  —  запутанный
subsequent  —  последующий
mention  —  упоминать
imply  —  подразумевать
to mention  —  упоминать о
advice  —  совет
consistent  —  последовательный, стойкий, совместимый
distinct  —  определённый
let down  —  разочаровать, подвести
disregard  —  игнорировать, пренебрегать
convince  —  убеждать
encourage  —  поощрять, поддерживать
entire  —  полный, целый, весь
significant  —  значительный
collaboration  —  сотрудничество
implicitly  —  безоговорочно
invoke  —  призывать, взывать
advantage  —  преимущество
profound  —  глубокий, основательный
slightly  —  слегка
matter of fact  —  На самом деле, фактически
disadvantage  —  неудобство, недостаток
whole point  —  все дело в, весь смысл
extensive  —  обширный
eventually  —  в конечном итоге
fuzzy  —  неясный
argued  —  спорил
either  —  каждый
recognize  —  распозновать, признать
familiarity  —  хорошая осведомлённость
discourage  —  отбивать охоту
favor  —  одолжение
